;	Cheap and dirty map file
;
;	Structures: 	Metadata:
;	# Massive		
;	H Hard			#Crystals, #Ore
;	A Normal 1		#Crystals, #Ore
;	B Normal 2		#Crystals, #Ore
;	C Normal 3		#Crystals, #Ore
;	  Ground		
;	. Rubble		Amount (0-5 with 5 the most), #Ore still inside
;	= Plate			
;	+ Building		Number, Orientation
;	* Building Pl.	
;	O OreF			
;	Y CrystalF		
;	- Lava			
;	~ Water			
;
;-------------------------------
;
;	TextureSet: 
img/map.png
;-------------------------------
;
;
;	Main Map:
################################
##   #####     ## ...   #####  #
##   ..ABB        ####   .### ##
####  AA       .    ####.     ##
### =##BB            ###### ####
### =#####        #=######  ####
## == #####     ##===##    #####
####  . ## #.####==#=   ##   ###
##=###     #     =#    ###.   ##
#===#### ...  ####### ##.   ####
#=#   #    ##   #####     #==###
#==##   #######   .  ..#####==##
##==########  == ..      ###==##
##   .########=###### ####### ##
###     .. ...= #####      ## ##
####### .   . ....####.#==  ..##
######    ###          #########
################################

;	Please keep the empty line above, this ends the level data
;	Metadata 1 (#Crystals, Rubble amount, Buildung ID)
00000000000000000000000000000000
00000000000000000000000000000000
00000000000000000000000000000000
00000000000000000000000000000000
00000000000000000000000000000000
00000000000000000000000000000000
00000000000000000000000000000000
00000000000000000000000000000000
00000000000000000000000000000000
00000000000000000000000000000000
00000000000000000000000000000000
00000000000000000000000000000000
00000000000000000000000000000000
00000000000000000000000000000000
00000000000000000000000000000000
00000000000000000000000000000000

;	Please keep the empty line above, this ends the level data
;	Metadata 2 (#Ore, Building Orientation)
00000000000000000000000000000000
00000000000000000000000000000000
00000000000000000000000000000000
00000000000000000000000000000000
00000000000000000000000000000000
00000000000000000000000000000000
00000000000000000000000000000000
00000000000000000000000000000000
00000000000000000000000000000000
00000000000000000000000000000000
00000000000000000000000000000000
00000000000000000000000000000000
00000000000000000000000000000000
00000000000000000000000000000000
00000000000000000000000000000000
00000000000000000000000000000000
























