;	Cheap and dirty map file
;
;	Structures: 	Metadata:
;	# Massive		
;	H Hard			#Crystals, #Ore
;	A Normal 1		#Crystals, #Ore
;	B Normal 2		#Crystals, #Ore
;	C Normal 3		#Crystals, #Ore
;	  Ground		#Workers, 1: Visible at start (and all connected)
;	. Rubble		Amount (0-5 with 5 the most), #Ore still inside
;	= Plate			#Workers, 1: Visible at start (and all connected)
;	+ Building		Number, Orientation
;	* Building Pl.	
;	O OreF			
;	Y CrystalF		
;	- Lava			
;	~ Water			
;
;-------------------------------
;
;	TextureSet: 
img/map.png
;-------------------------------
;
;
;	Main Map:
################################
#=== #####BBAAA##AA     #####CC#
#=+=  AABBB      A####  + ###C##
#==   AABBA   ==   A####    AC##
###AA##BBAA  ==+  BBB###### ####
###BC#####   === B#C######AB####
##CCCB#####     A#BCB##AAAB#####
####AA  ## #H####BA#    ##BBB###
##A###    A#      ##   ###BBBB##
#AAA#### AAA  #######H##HHBB####
#A#BBB#AAAA##   #####HCCCH#==###
#AA##CCC#######HH      #####==##
##  ########             ###==##
##    ########H######H#######=##
###   AAABCA====#####    BC##=##
#######BBBCBA=+===####A#CCCHHH##
######    ###====AAABBC#########
################################

;	Please keep the empty line above, this ends the level data
;	Metadata 1 (#Crystals, Rubble amount, Buildung ID)
00000000000000000000000000000000
00100000000100000000000000000030
01020000000000000000000000000000
00200010001000000000000000000000
00000000000000000000000000000000
00001000000000000000000000000000
00300000000000002010000010000000
00001000000000000000000000000000
00000000000000000000000000020100
00100000000000000000000000000000
00000001000000000000000100000000
00000000000000000000000000000000
00000000000000000000000000000000
00000000000000000000000000000000
00000001020000000000000000100000
00000000000100000000000001000000
00000000000000000001200000000000
00000000000000000000000000000000

;	Please keep the empty line above, this ends the level data
;	Metadata 2 (#Ore, Building Orientation)
00000000000000000000000000000000
00000000003010100200000000000100
00000020100000000100000000000000
00010001120000000000000000000100
00010001000000000001000000000000
00010000000000000000000000000000
00031000000000000011000003100000
00000100000000000130000000001000
00000000001000000000000000000000
00010000000000000000000011100000
00010200020000000000010000000000
01000001000000021000000000000000
00000000000000000000000000000000
00000000000000000000000000000000
00000000101000000000000001000000
00000000110000000000000000002100
00000000000000000010001000000000
00000000000000000000000000000000

























