;	Cheap and dirty map file
;
;	Structures: 	Metadata:
;	# Massive		
;	H Hard			#Crystals, #Ore
;	A Normal 1		#Crystals, #Ore
;	B Normal 2		#Crystals, #Ore
;	C Normal 3		#Crystals, #Ore
;	  Ground		#Workers, 1: Visible at start (and all connected)
;	. Rubble		Amount (0-5 with 5 the most), #Ore still inside
;	= Plate			#Workers, 1: Visible at start (and all connected)
;	+ Building		Number, Orientation
;	* Building Pl.	
;	O OreF			
;	Y CrystalF		
;	- Lava			
;	~ Water			
;
;   Keep all empty lines, this is what the loader uses as divider. 
;	(and line lengths over 1024 make us crash, try to avoid that)
;
;	TextureSet: 
img/map.png

;	Number of crystals to gather to complete the level (0 ignores it)
25

;	Number of ore to gather to complete the level (0 ignores it)
0

;	Number of artifacts to discover to complete the level (0 ignores it)
0

;	Number of buildings to own to complete level (0 ignores it)
0

;	The level introduction text: 
- ... So, just 25 crystals? Nothing more? Nothing
  special?
- Nothing special, thats all.
- All, huh? Isn't this the same cave where you already
  sent 8 men yesterday? 
- That didn't ever return back?
- Who we haven't heard literally anything about since? 
- And why is the entrance blocked, that the team 
  drill-opened yesterday?
- You JUST collect 25 crystals. That's YOUR job. 
- AND WHAT ABOUT THE TRAPPED WORKERS???

;	The level completion text:
Hehe see, we got all the 20 crystals. 
Good work! About the workers, though ...
... I mean, we saved at least *some* of them. 
Didn't we?

;
;	Main Map:
;	
######################################################
########~~~~~######  #####################      A#####
######~~~###~~~~~       #########BCCBA..   ===== A####
####~~~#######~~     ##AA######ABBCCB####  ==+==  ####
###~~####CCC###~    ###BBB     A###########  ..   ####
###~####ABBAA###B#####BB   ~~~  ############A.########
###~~#~~     ##BB#####   ~~~~~  ############A.########
####~~~~    ##AAC#####    ~~~   ##########   .########
####~~       AAC#######       AA#########      ####A##
####C       ##########CC####AAA##########       ##--##
#####CC   ############BC###################     ---###
######H########A###ABBB###################AA   ---####
##     #######AA     ABB################BBB####--#####
##      ##BBBBB   +   AB###    #####    AA#####--#####
###     #CCBBBBB     #ABB      BBB    +  ######--#####
###     HC################      ####     A######--####
####   A#####################BB######   ABCH#####--###
#####AAH##############  #####BCC####HC#AA##CB#####--##
#####BH       #######    #####CC###BC######    ###--##
######  =====   #######  B#####H   AB#####  === ##--##
######  ==+==   #######BBB#### ====  ###### ===   --A#
#####   =====  ######AAAA      =+== #####B  =+=  ---A#
#######  ====######     =========== #####B  ===  --A##
#######AA ====#### ======    ~~    ########    #--####
######BB###=========    ####~~~~~#######CCCH####--####
######BC####=======  ########~~~~##ABCCCC########--###
######CC####### ===    ###########A.ABBC#########--###
####     ######  ====       ######A.AAAAC#######--####
##----    ###      ===============.....BB#####B--#####
#-----    A#####            ######B.BBBB#####B--######
#----   ##AB####H###       #######C.BBC#####---     ##
##B    ###BB     ##################CCC####---      A##
###BBB####C   +   ##-----####-----####-----      BB###
###########BB   --------------------------###   ######
##############------#####-----##HHH-----##############
######################################################

;	Metadata 1 (#Crystals, Rubble amount, Buildung ID, #workers)
000000000000000000000000000000000000000000000000000000
000000000000000000000000000000000000000000000000000000
000000000000000000000000000000000000000000000000010000
000000000000000000000000100000000100000000001000000000
000000000010000000000000000000000000000000000450000000
000000000001000000000010000000000000000000000300000000
000000000000000000000000000000000000000000001400000000
000000000000001000000000100000000000000000000500000000
000000000000000000000000000000010000000000000000000000
000010000000000000000001000000000000000000000000000000
000000000000000000000000000000000000000000000000000000
000000000000000000000000000000000000000000000000000000
000000000000000000000000000000000000000000000000000000
000001000000100004000000000000000000000010000000000000
000000000000000000000000000001001000010000000000000000
000000000100000000000000000000000000000000000000000000
000000000000000000000000000000000000000000000000000000
000000000000000000000000000000100000000010000000000000
000002000000000000000000000000000000000000000000000000
000000000000000000000000000000000000000000000100000000
000000000000000000000001000000000000000000000000000000
000000000000000000000000000000100000000002000000000000
000000000000000000000000000000000000000000000000000000
000000000000000000000000000000000000000000000000000000
000000000000000000000000000000000000000000200000000000
000000100000000000000000000000000001010000000000000000
000000010000000000000000000000000001000000000000000000
000000000000000000000000000000000002000010000000000000
000000000000000000000000000000000043210000000000000000
000000000000000000000000000000000002010000000000000000
000000000000000010000000000000000001000000000000000000
001000000000000000000000000000000000020000000000000000
000100000000010000000000000000000000000000000000000000
000000000001000000000000000000000000000000000000000000
000000000000000000000000000000000000000000000000000000
000000000000000000000000000000000000000000000000000000

;	Metadata 2 (#Ore, visible at start)
000000000000000000000000000000000000000000000000000000
000000000000000000000000000000000000000000000000000000
000000000000000000000000000000000000010000000000000000
000000000000000000000000000000001000000000000000000000
000000000100000000000001000000000000000000000000000000
000000000000000000000000000000000000000000002000000000
000000000000000010000000000000000000000000000000000000
000000000000000000000000000000000000000000000000000000
000000000000000000000000000000000000000000000000000000
000000000000000000000000000000100000000000000000000000
000001000000000000000000000000000000000000000000000000
000000000000000000000000000000000000000000000000000000
000000000000000000000010000000000000000001000000000000
000000000000000001000000000000000000000000000000000000
000000000010000000000001000000000000000000000000000000
000000001000000000000000000000000000000000000000000000
000000000000000000000000000000000000000000100000000000
000000100000000000000000000000000000000000000000000000
000000000000000000000000000000000000000000000000000000
000000000000000000000000000000000000100000000000000000
000000000000000000000000000000000000000000000000000000
000000000000000000000100100000000000000000000000000000
000000000000000000000000000000000000000000000000000000
000000000000000000000000000000000000000000000000000000
000000010000000000000000000000000000000000000000000000
000000000000000000000000000000000000000010000000000000
000000000000000000000000000000000000000000000000000000
000000000000000000000000000000000000010000000000000000
000000000000000000000000000000000000000000000000000000
000000000000000000000000000000000000000000000000000000
000000000010000000000000000000000010000000000000000000
000000000000000000000000000000000000000000000000000000
000010000000000000000000000000000000000000000000000000
000000000000000000000000000000000000000000000000000000
000000000000000000000000000000000000000000000000000000
000000000000000000000000000000000000000000000000000000




